00000000220000000000000000000000
00000000220000000000000000000000
00000000110000000000000000000000
00000000110000000000000000000000
00000000111111111111111111110000
00000000111111111111111111110000
00000000000000000000000000110000
00000000000000000000000000110000
00000000000000000000000000110000
00000000000000000000000000110000
00001111111111111111111111110000
00001111111111111111111111110000
00001100000000000000000000000000
00001100000000000000000000000000
00001111111100000000000000000000
00001111111100000000000000000000
00000000001100000000000000000000
00000000001100000000000000000000
00000000001100000000000000000000
00000000003300000000000000000000