00000000000000000000000022000000
00000000000000000000000022000000
00000000000000000000000011000000
00000000000000000000000011000000
00000000111111111111111111110000
00000000111111111111111111110000
00000000110000000000000000110000
00000000110000000000000000110000
00000000110000000000000000110000
00000000000000000000000000110000
00000000001111111111111111110000
00000000001111111111111111110000
00000000001100000000000000000000
00000000001100000000000000000000
00000000001111111111111111111100
00000000001111111111111111111100
00000000000000000000000000001100
00000000000000000000000000001100
00000000000000000000000000001100
00000000000000000000000000003300