00000000000000000000000022000000
00000000000000000000000055000000
00000000000000000000000011000000
00000000000000000000000011000000
00000000001111111111111111000000
00000000001111111111111111000000
00000000001100000000000011000000
00000000001100000000000011000000
00000000001100000000000011000000
00000000004400000000000011000000
00000000001111111111111111000000
00000000001111111111111111000000
00000000001100000000000011000000
00000000001100000000000011000000
00000000001111111111111111000000
00000000001111111111111111000000
00000000000000000000000011000000
00000000000000000000000011000000
00000000000000000000000011000000
00000000000000000000000033000000