00000000000000220000000000000000
00000000000000550000000000000000
00000000000000110000000000000000
00000000000000110000000000000000
00001111111111111111111111110000
00001111111111111111111111110000
00001100000000000000000000110000
00001100000000000000000000110000
00001100000000000000000000110000
00004400000000000000000000110000
00000000000011111111111111110000
00000000000011111111111111110000
00000000000011000000000000000000
00000000000011000000000000000000
00000000000011000000000000000000
00000000000011000000000000000000
00000000000011111111110000000000
00000000000011111111110000000000
00000000000000000000110000000000
00000000000000000000330000000000