00000000000002200000000000000000
00000000000002200000000000000000
00000000000001100000000000000000
00000000000001100000000000000000
00011111111111111111111111110000
00011111111111111111111111110000
00011000000000000000000000110000
00011000000000000000000000110000
00011000000000000000000000110000
00044000000000000000000000110000
00000000000011111111111111110000
00000000000011111111111111110000
00000000000011000000000000000000
00000000000011000000000000000000
00000000000011000000000000000000
00000000000011111111110000000000
00000000000011111111110000000000
00000000000000000000110000000000
00000000000000000000110000000000
00000000000000000000330000000000